#####S#########
#OOO#OOOO#OOOO#
#O#OOOO#O#O##O#
#OOO######O#OO#
##O#OOOO#OO#O##
#OOOO##OOO##O##
############E##
